11111111111111111
1P000111001111001
10001100001001001
10011001000011001
100100C1000110001
10011111101100001
10000001001C01001
10000001001111001
100000000000000E1
11111111111111111
