11111111111111111111111111
1000P111111100000001111111
10000000000000000000000001
10000000000000000000000001
10111111110000000000000001
101100C1100000000000000011
10000000000000000111000E11
11111111111111111111111111
