1111111
1C00001
100P001
1111111
