1111111
1000001
1CPE001
1111110
