11111111111111111
1P00C111C011110C1
100011000010C1001
10011001000011001
100100C1000110011
10011111101100011
100000C1001C01001
10111001001111001
100100000000000E1
11111111111111111
