1111111111
110000P001
1E01111001
10010C1001
1001P00001
1111111111
