11111
10C01
10001
1P0E1
11111
